yYEGkKrX#%|----
---------------
---------------
---------------
---------------
---------------
---------------
---------------
---------------
---------------
---------------
---------------
------------F--
-M----------#--
XXXXXXXXXXXXXXX
XXXXXXXXXXXXXXX