--------------------------------------------------
--------------------------------------------------
--------------------------------------------------
--------------------------------------------------
--------------------------------------------------
--------------------------%-----------------------
--------------------------------------------------
--------------------------------------------------
--------------------------------------------------
--------------------#g-g-g---g---g-#--------------
---------------------##############---------------
--------------------------------------------------
--M--#############----------------------------F---
--g-----------------##################--------#---
XXXXXXXXXXXXXXXXXXXXXXXXXXXXXXXXXXXXXXXXXXXXXXXXXX
XXXXXXXXXXXXXXXXXXXXXXXXXXXXXXXXXXXXXXXXXXXXXXXXXX