----------------------------------------------------
----------------------------------------------------
----------------------------------------------------
----------------------------------------------------
----------------------------------------------------
----------------------------%-----------------------
----------------------------------------------------
----------------------------------------------------
----------------------------------------------------
----------------------#g-g-g---g---g-#--------------
-----------------------##############---------------
----------------------------------------------------
----------############--------------------------F---
--M-g-----------------##################--------#---
XXXXXXXXXXXXXXXXXXXXXXXXXXXXXXXXXXXXXXXXXXXXXXXXXXXX
XXXXXXXXXXXXXXXXXXXXXXXXXXXXXXXXXXXXXXXXXXXXXXXXXXXX